.  . . . . . . . . . .
.  . . @ . . . @ G . .
.  . . @ G . . @ @ . .
.  . . @ . . . . . . .
.  . . . . . . . . . .
S0 . . . . . . . . . X
.  . . G . . . . . . .
.  . . . . . . . . . .
.  . . @ @ @ @ @ . . .
.  . . @ G . . . . . .